111111111111111111
111111010101010101
100000000000000001
100000000CCCCCC011
1P000000000000E001
111111111111111111
