1111111111
1000000001
1CP00000E1
1111111101