11111111111
1P000000001
11111110001
3