11111111111111111
10C000000000000E1
1000000P000100001
100000000001C0001
10000011000100111
11111111111111111