111111111
100000001
1EC0000P1
111111111
